NO ./banner.xpm
SO ./grey.xpm
WE ./wood.xpm
EA ./brick.xpm

F 10,10,10
C 50,50,50

1111111111111111111111111
1000000000110000000000001
1011000001110000E00000001
100100000000000000000000011111111
111111111011000001110000000000001
100000000011000001110111111111111
11110111111111011100000010001
11110111111111011101010010001
11000000110101011100000010001
10000000000000001100000010001
10000000000000000101010010001
110000011101010111110111100111
11110111 1110101 101111010001
11111111 1111111 111111111111
