NO ./textures/banner.xpm
SO ./textures/grey.xpm
WE ./textures/wood.xpm
EA ./textures/brick.xpm

F 220,100,0
C 225,30,0

1111111
111E111
1110111
1110111
1110111
1110111
1110111
1110111
1110111
1110111
1110111
1110111
1110111
1110111
1110111
1110111
1110111
1110111
1110111
1110111
1	  1
1111111