NO ./textures/banner.xpm
SO ./textures/grey.xpm
WE ./textures/wood.xpm
EA ./textures/brick.xpm

F 220,100,0
C -1,30,0

1111111
1000001
100N001
1111111