NO ./textures/banner.xpm
SO ./textures/grey.xpm
WE ./textures/wood.xpm
EA ./textures/brick.xpm

F 220,100,0
C 225,30,0

11111
1111
1111E11
11111