NO ./textures/banner.xpm
SO ./textures/grey.xpm
WE ./textures/wood.xpm
EA ./textures/brick.xpm

F 220,100,0
C 225,30,0

1111111
11111111111111111111111111111111111111111111111111111111111111111111111111111111
1E                                                                              1
11111111111111111111111111111111111111111111111111111111111111111111111111111111