NO ../textures/banner.xpm
SO ../textures/grey.xpm
WE ../textures/wood.xpm
EA ../textures/brick.xpm



1111111
1000001
100N001
1111111


F 220,100,
C 225,30,0