NO ./textures/grey.xpm
SO ./textures/grey.xpm
WE ./textures/wood.xpm
EA ./textures/brick.xpm

F 10,10,10
C 255,50,100

1111111111111111111111111111111111111111111111111111111111111111111111111111111111111111111
1000000000000000000000000000000000000000000000000000000000000000000000000000000000000000001
1E00000000000000000000000000000000000000000000000000000000000000000000000000000000000000001
1000000000000000000000000000000000000000000000000000000000000000000000000000000000000000001
1111111111111111111111111111111111111111111111111111111111111111111111111111111111111111111
